1111111111111111111111
1000E110001000000000P1
100001000100C000000111
100011000C0000C0000001
1111111111111111111111
